 R 800 600
 NO ./pictures/piki.xpm
SO ./pictures/2 2.xpm
WE ./pictures/dama_kresti.xpm
EA ./pictures/greystone.xpm
S ./pictures/bochka.xpm

F 51  ,          0,53
C 120,			50,50

11111111111111111111111111111
10000000001100000000200000001
10110000011100000000000012221
10210000000020000000N00012221
10110000011100000000000010001
10000000001100000111011110001
11110111111111011100000010001
11110111111111011101010010001
11000000110101011100000010001
10000000000000001100000010001
10000000000000001101010010001
11000000110101000000000000001
11110111110101000000000000001
10000000001100000100000010001
10000000000000001010000101001
10000000001000010001010001001
10000000001101000000000000001
10020000000100000001010000001
10000000000000000000000000201
11111111111111111111111111111
11111111111111111111111111111
