R 1200 1000
NO ./pictures/greystone.xpm
SO ./pictures/greystone.xpm
WE ./pictures/greystone.xpm
EA ./pictures/greystone.xpm
S ./pictures/bochka.xpm

F 51  ,   51   ,       153
C 120,			50,51

11111111111111111111111111111
12000000001120000000200000001
10110000011100000000000010001
10010000000000000000000010001
10110000011100000000N00010001
10000000001100000111011110001
11110111111111011100000010221
11110111111111011101010010001
11000000110101011100000010001
10000000000000001100000010001
10000000000000001101010010001
11000000110101000000000000001
11110111110101000000000000001
10000000001100000100000010001
10001000000000001010000101001
10001100001000010001010001001
10001000001101000000000000001
10000000000100000001010000001
10000000000000000000000000001
11111111111111111111111111111
11111111111111111111111111111
