R 800 600
NO ./pictures/greystone.xpm
SO ./pictures/greystone.xpm
WE ./pictures/greystone.xpm
EA ./pictures/greystone.xpm
S ./pictures/bochka.xpm

F 51  ,   51   ,       153
C 120,			50,51

11111111111111111111111111111
10000000001120000000200002221
10110000011122200000000012221
10010000000022200000000012221
10110000011100220000N00012221
10000000001100000111011110001
11110111111111011100000010001
11110111111111011101010010001
11000000110101011100000010001
10000000000000001100000010001
10000000000000001101010010001
11000000110101000000000000001
11110111110101002200000000001
10000000001100000100000010001
10000000000000001010000101001
10000000001000010001010001001
10000000001101000000000000001
10020000000100000001010000001
10000000000000000000000000001
11111111111111111111111111111
11111111111111111111111111111
