11111111111111111111111111111
10000000001100000000000000001
10110000011100000020000010001
10010000000000200000000010001
10110000011100000200000010011
10000000001100000111011110001
			11110111111111011100000010001
11110111111111011101010010001
110000	00110101011100000010001
1000200000	0000001100000010001
10000000000000001101010010001
10000000000000001101010010N01
1100000011010	1	011111011110001
1111011111110101	1111011110001
11111111111111	111	1	11111111111
10002000000000001100000010001
1000000000000	0001101010010001
11111111111111111111111111111
